NO img/2.xpm

WE img/1.xpm

SO img/2.xpm

EA img/1.xpm

C 0,115,216
F 156,156,156


1111111111111111111111111
1000000000110000000000001
1011000001110000000000001
10010000000000000000000001111111
11111111101100000111000000000001
10000000001100000111011111100111
111101111111110111000000100001
111101011111110111010010010001
11000000110101011100000010001
10000000000000001100000010001
10000000000000001101010010001
11000011N01010111110111000111 
1111011111110101 101111010001
11111111 1111111 11111111111