NO img/2.xpm

WE img/1.xpm

SO img/3.xpm

EA img/4.xpm

C 0,115,216
F 156,156,156


1111111111111111111111111
1000000000110000000000001
1011000001110000000000001
10010000000000000000000001111111
111111111011000001110000000000N1
100000000011000001110111111001001
11110111111111011100000010000111
111101011111110111010010010001
11000000110101011100000010001
10000000000000001100000010001
10000000000000001101010010001
11000011001010111110111000111
1111011111110101 101111010001
11111111 1111111 11111111111
111111111111111111111111111111111