NO img/2.xpm

WE img/1.xpm

SO img/3.xpm

EA img/4.xpm

C 0,115,216
F 156,156,156

111111111111111111111111111111111111111111111111111
100000000000000000000000000000000000000000000000001
100110000000000000000000000000000001000000000000001
100000000000000010000000000000000001000000000000001
100000000000010101000001000000000001011110000000001
100000100111101010111110111110000001000000000000001
100001000100000000000010000010000000000000000000001
100100000101000000100010000010000000000000000000001
100100000101000001001010000010000000000000000000001
100010000101000011000010000010000000000000000000001
100000000101000000000010000010000000000000000000001
100111111101000010000010000011111100000000000000001
1N0000000001000000000000000000000000000000000000001
111111111111111111111111111111111111111111111111111